0 0 0 0 0 0 0 8 1 1 1 1 1 1 1 1 1 1 9 0 0 0 8 1 1 1 1 1 1 1 1 1 1 9 0 0 0 0 0 0 0 0 0
0 0 0 0 0 0 0 3 5 5 5 5 5 5 5 5 5 5 4 0 0 0 3 5 5 5 5 5 5 5 5 5 5 4 0 0 0 0 0 0 0 0 0
0 0 0 0 0 0 0 3 5 5 5 5 5 5 5 5 5 5 4 0 0 0 3 5 5 5 5 5 5 5 5 5 5 4 0 0 0 0 0 0 0 0 0
0 0 0 0 0 0 0 3 5 5 5 5 5 5 5 5 5 5 4 0 0 0 3 5 5 5 5 5 5 5 5 5 5 4 0 0 0 0 0 0 0 0 0
0 0 0 0 0 0 0 3 5 5 5 5 5 5 5 5 5 5 4 0 0 0 8 1 1 1 1 1 1 1 1 1 1 9 0 0 0 0 0 0 0 0 0
0 0 0 0 0 0 0 3 5 5 5 5 5 5 5 5 5 5 4 0 0 0 3 5 5 5 5 5 5 5 5 5 5 4 0 0 0 0 0 0 0 0 0
0 0 0 0 0 0 0 3 5 5 5 5 5 5 5 5 5 5 4 0 0 0 3 5 5 5 5 5 5 5 5 5 5 4 0 0 0 0 0 0 0 0 0
0 0 0 0 0 0 0 3 5 5 5 5 5 5 5 5 5 5 4 0 0 0 3 5 5 5 5 5 5 5 5 5 5 4 0 0 0 0 0 0 0 0 0
8 1 1 1 1 1 9 6 5 5 5 5 5 5 5 5 5 5 7 1 1 1 6 5 5 5 5 5 5 5 5 5 5 7 8 1 1 1 9 0 0 0 0
3 5 5 5 5 5 4 5 5 5 5 5 5 5 5 5 5 5 5 5 5 5 5 5 5 5 5 5 5 5 5 5 5 5 3 5 5 5 4 0 0 0 0
3 5 5 5 5 5 4 5 5 5 5 5 5 5 5 5 5 5 5 5 5 5 5 5 5 5 5 5 5 5 5 5 5 5 3 5 5 5 4 0 0 0 0
3 5 5 5 5 5 4 5 5 5 5 5 5 5 5 5 5 5 5 5 5 5 5 5 5 5 5 5 5 5 5 5 5 5 3 5 5 5 4 0 0 0 0
6 2 2 2 2 2 7 2 2 2 2 2 2 2 2 8 1 1 1 1 1 1 1 1 1 1 1 1 2 2 2 2 2 2 6 2 2 2 7 0 0 0 0
0 0 0 0 0 0 0 0 0 0 0 0 0 0 0 3 5 5 5 5 5 5 5 5 5 5 5 5 4 0 0 0 0 0 0 0 0 0 0 0 0 0 0
0 0 0 0 0 0 0 0 0 0 0 0 0 0 0 3 5 5 5 5 5 5 5 5 5 5 5 5 4 0 0 0 0 0 0 0 0 0 0 0 0 0 0
0 0 0 0 0 0 0 0 0 0 0 0 0 0 0 3 5 5 5 5 5 5 5 5 5 5 5 5 4 0 0 0 0 0 0 0 0 0 0 0 0 0 0
0 0 0 0 0 0 0 0 0 0 0 0 0 0 0 3 5 5 5 5 5 5 5 5 5 5 5 5 4 0 0 0 0 0 0 0 0 0 0 0 0 0 0
0 0 0 0 0 0 0 0 0 0 0 0 0 0 0 3 5 5 5 5 5 5 5 5 5 5 5 5 4 0 0 0 0 0 0 0 0 0 0 0 0 0 0
0 0 0 0 0 0 0 0 0 0 0 0 0 0 0 3 5 5 5 5 5 5 5 5 5 5 5 5 4 0 0 0 0 0 0 0 0 0 0 0 0 0 0
0 0 0 0 0 0 0 0 0 0 0 0 0 0 0 6 2 2 2 2 2 2 2 2 2 2 2 2 7 0 0 0 0 0 0 0 0 0 0 0 0 0 0
0 0 0 0 0 0 0 0 0 0 0 0 0 0 0 0 0 0 0 0 0 0 0 0 0 0 0 0 0 0 0 0 0 0 0 0 0 0 0 0 0 0 0
